Humans: 0
RRRRRRRRRRRRRRRRRRRRRRRRRRRRRRRRRRRRRRRRRRRRRRRRRRRRRRRRRRRRRRRRRRRRRRRRRRRRRRRRR
RRRRRRRRRRRRRRRRRRRRRRRRRRRRRRRRRRRRRRRRRRRRRRRRRRRRRRRRRRRRRRRRRRRRRRRRRRRRRRRRR
RR.............................................................................RR
RR.............................................................................RR
RR.............................................................................RR
RR.............................................................................RR
RR.............................................................................RR
RR.....Z.................................................................Z.....RR
RR.............................................................................RR
RR.............................................................................RR
RR.............................................................................RR
RR.............................................................................RR
RR.............................................................................RR
RR.............................................................................RR
RR.............................................................................RR
RR.............................................................................RR
RR.............................................................................RR
RR.............................................................................RR
RR.............................................................................RR
RR.............................................................................RR
RR.............................................................................RR
RR.............................................................................RR
RR.............................................................................RR
RR.............................................................................RR
RR.............................................................................RR
RR.............................................................................RR
RR.............................................................................RR
RR.............................................................................RR
RR......................................@......................................RR
RR.............................................................................RR
RR.............................................................................RR
RR.............................................................................RR
RR.............................................................................RR
RR.............................................................................RR
RR.............................................................................RR
RR.............................................................................RR
RR.............................................................................RR
RR.............................................................................RR
RR.............................................................................RR
RR.............................................................................RR
RR.............................................................................RR
RR.............................................................................RR
RR.............................................................................RR
RR.............................................................................RR
RR.............................................................................RR
RR.............................................................................RR
RR.............................................................................RR
RR.............................................................................RR
RR.............................................................................RR
RR.....Z................................................................Z......RR
RR.............................................................................RR
RR.............................................................................RR
RR.............................................................................RR
RR.............................................................................RR
RR.............................................................................RR
RRRRRRRRRRRRRRRRRRRRRRRRRRRRRRRRRRRRRRRRRRRRRRRRRRRRRRRRRRRRRRRRRRRRRRRRRRRRRRRRR
RRRRRRRRRRRRRRRRRRRRRRRRRRRRRRRRRRRRRRRRRRRRRRRRRRRRRRRRRRRRRRRRRRRRRRRRRRRRRRRRR